#Example: Most of Europe north of med.
#mild_winter = {
# Nothing. Everything temperate for now
#}
#Example: Inland Europe & Scandinavia
#normal_winter = {
# Nothing. Everything temperate for now
#}
#Example: Russia & Lappland
#severe_winter = {
# Nothing. Everything temperate for now
#}

#vanilla settings, let's see how it works
#Example: Most of Europe north of med.
mild_winter = {
	# Ireland
	8 10 12
	# Ireland
	3 4 5 7 9 11 13 14 15 16
	# Ireland
	975 976 1435 1436 1433 1434 1432 1428 1429 1430
	# British Isles
	54
	# England & Wales
	17 18 19 20 21 22 23 24 25 26 27 28 29 30 31 32 52 53 55 56 57 58 59 60 61 62 63 64 65 66 67 68 69 70 71 72 73
  945 946 947 949 964 973 974 983 1183 1409 1410 1411 1412 1413 1414 1415 1416 1418 1471 1472 1473
	# Netherlands
	74 76 77 78 79 90 91 92 93 94 113 115 116 117 118 129
  1017 1019 1056 1057 1058 1059 1956 1957
	# France
	75 95 96 97 98 99 107 108 109 110 111 112 114 130 131 132 135 136 137 138 139 140 141 142 144 143 145 146 147 149 150 212 213 214 215 216 218 220 221 222 225 226 227 230 239 240 148
  1047 1159 1160 1161 1162 1163 1164 1166 1168 1169 1170 1171 1172 1173 1174 1175 1176 1177 1179 1180 1181 1185 1186 1189 1246 1249 1250 1253 1256
	# Brittany
	100 101 102 103 104 105 106 
	# Italy
	233 234 319 320 321 322 324 328 329 349 350 351 352 353 354 355 457 461 462 463
  1101 1102 1103 1104 1106 1109 1112 1113 1114 1115 1116 1119 1120 1129 1133 1141 1143 1145 1316 1318 
	# Iberia
	173 174 175 176 177 178 181 189 190 192 196 197 198 199 200 201 202 203 204
  1190 1191 1192 1193 1194 1196 1197 1198 1199 1201 1202 1203 1204 1206 1207 1208 1209 1214 1216 1217 
	# Mongol Empire
	299 621 623 625 626 628 900 901 902 903 1536 1557 1561 1562
	# Albania
	561 562 600 560 1011 1013
	# Turkey
	681 702 703 706 707 736 737 749 751 759 752 753 760 941 944
  1070 1158 1218 1219 1220 1332 1325 1228 1261 1241 1234 1233 1222 1347
  # & Caucasus
  701 726 816 1081 1083 1086 1088 1092 1094 1095 1097 1530
	# Persia
	632 634 640 644 646 650 660 663 664 665 904 907 1531 1534 1537 1542 1543 1544 1548 1594
	# Central Asia
	1567 1568 1569 1570 1580 1178 1968
	# Other
	674 668 669 673 677 670 672 682 704 667 666 686 1581 1582 1611 1628 1699 1979 1980 1981 2061
}

#Example: Inland Europe & Scandinavia
normal_winter = {
	# British Isles
	33 34 35 36
	# Lower Scandinavia
	303 305 6 931 302 301 300 1144 1310 1587
	# Scotland
	37 38 39 40 41 42 43 44 45 46 47 48 49 50 51
        1431 1425 1426 1427 1419 1420 1421 1422 1423 1424 1488 1484 1479 1470 
	# Denmark
	259 260 261 262 263 264 265 266 267 304 306 307 308 950 1027 1043 1051 1052 1182 1304 1505 1584 1585 1586
	# East Frisia
	80 81 82 83 84 85 86 87 88 89 119 120 121 122 254 255 256 257 258 309 310 311 312 313
	# France
	217 219 223 224 242 209 229
	930 1036 1156 1157 1165 1167 1187 1188 1251 1252 1255
  # Germany
	124 125 126 127 128 133 134 245 248 249 250 251 365 366 367 368 369 370 371 372 430 434 435 436 438 446 447 448 449
  942 948 951 952 953 954 955 960 970 972 977 978 980 981 982 998 1007 1008 1009 1018 1020 1021 1022 1024 1025 1026 1029 1030 1031 1032 1033 1034 1035 1053 1054 1060 1061 1062 1063 1064 1065 1066 1074 1075 1076 1077 1078 1079 1098 1184 1247 1264 1317 1963 1964 1965 1966 1408 1248 1380 1028
	1958 1959 1960 1961 1962 1967
	# Poland/Lithuania
	373 374 420 421 422 423 424 425 426 427 428 429 431 432 433 440 441 443 444 445 451 454 450 520 521 523 524 
	526 527 528 529 530 531 533 535 536 537 539 540 541 544 545 546 548 549
   962 963 966 979 984 985 986 987 988 989 990 991 992 993 996 997 999 1055 1068 1267 1297 1298 1299 1300 1301 1302 1303 1305 1307 1308 1309 1313 1314 1315 
	# Pyrenees
	152 151 206 211 1205 1210 2013
  #Italy mountains
  246 929 956 957 1039 1042 1044 1045 1117 1121 1122 1123 1124 1125 235 1131 1132 1137 1139 1140 1148
	# Hungary
	492 498 499 500 501 502 503 504 505 506 507 508 509 510 514 515 516
  # & Balkans
  961 1000 1001 1002 1004 1005 1006 1012 1015 1127 1149 1151 1152 1155 1312 1522 1523 1524 1525 1526 1527 1528 1529 1224 1417 471
  #Caucasus & Russian steppe
  601 1080 1082 1084 1085 1087 1089 1096 1695 1696 566 895 565 594 556 671 680
  1146 1147 1232 1279 1280 1281 1282 1284 1285 1288 1293 1294 1350 1357 1359 1407 1607 1698 2048 2054 
	# Other
	123 252 253 314 315 360 361 362 363 364 437 439 452 453 460 511 512 513 517 518 519 542 543 557 563 596 605 607 618 620 848 897 896 1263 1265
	604 606 675 603 602 599 597 598 558 559 1107 1134 1333
	# Central Asia
	622 852 887 893 905 1541 1545 1546 1547 1550 1551 1556 1558 1559 1560 1563 1564 1565 1571 1572 1573 1578
	#Baltics
	375
	#Tibet
	1975 1976
}

#Example: Russia & Lappland
severe_winter = {
	# Iceland
	1 2
	# Scandinavia
	279 280 386 387 388 389 391 268 269 270 271 272 273 274 275 276 277 278 281 282 283 284 285 286 287 288 289 290 291 292 293 294 295 296 297 298 383 384 385 382 381 390 392 932 376 377 378 379 380 411 413 415 1010 1050 1067 1071 1072 1073 1099 1100 1257 1258 1278 1289 1311
	# Russia
	393 394 395 396 397 398 850 888 889 890 892 910 1306 399 400 401 402 403 404 405 406 407 408 409 410 412 414 417 551 552 553 554 555 564 567 568 569 570 571 572 573 574 575
	576 577 578 579 580 581 582 583 584 585 586 587 588 589 590 591 592 593 595 608 609 610 611 612 613 614 615 616 617 619 886 891 898 933 416 419 418 934 550 547 994 995 1292
    1268 1269 1270 1271 1272 1273 1274 1275 1276 1277 1287 1296 1831 
	# Pyrenees
	207 967 210 208 205
	# Alps
	1048 1049 231 236 232 1130 318 317 357 358 455 456 359 316 247 244 238 237 241 228
	1037 1038 1040 1046 1142 1290
	# Carpathians
	442 522 525 532 534 538 1150 1153 1154 
	# Caucasus
	676 679 1090 1091 1093 1697
	# UpperAsia
	906 1540 1553 1555 1566 1574 1575 1576 1577 1579 1583 1588 1589 1969 1970
    # Wasteland Pechora
	1832 1974
	# Tibet
	1977 1978 1982 1983 1984 1985 1986 1987 1988 1989 1990
}
