#empty for now, can support this if need be.

region_scandinavia = {
}

region_british_isles = {

		3 4 5 7 8 9 10 11 12 13 14 15 16 17 18 19 20 21 
		22 23 24 25 26 27 28 29 30 31 32 35 36 37 38 39 
		40 41 42 43 44 45 46 47 48 49 50 51 52 53 55 
		56 57 58 59 60 61 62 63 64 65 66 67 68 69 70 71 
		72 73 945 946 947 949 964 973 974 983 1183 1409 
                1410 1411 1412 1413 1414 1415 1416 1417 1418 
                1436 1435 1433 1434
                1432 1428 1429 1430 1431 1425
                1419 1420 1421 1422 1423 1424 1488 1484 
                1479 1470 1471 1472 1473
}

region_iberia = {
}

region_italy = {
}

region_france = {
}

region_north_africa = {
}

region_levant = {
}

region_balkans = {
}

region_eastern_europe = {
}

region_sahara = { 

                829 837 1222 1223 1224 1225 1226 1227 1228 1229 
                1231 1235 1395 1396 1397 1398 1392 1400 
                1403 1404 1405 1407 1408 

}